101011111
111111101
101111011
011111011
111101011
101111001
111111111
111101111
111111101

100000000
111111000
000001000
000001000
000001000
000001000
000001111
000000001
000000001

111110111
111001111
111111111
111111111
101110001
110111111
111110111
011111111
100001011

111000000
001000000
001111111
000000001
000000001
000000001
000000001
000000001
000000001

110100100
110111111
011111011
111111111
111011101
111111110
111110111
111110111
111111101

110000000
010000000
011111000
000001100
000000100
000000110
000000011
000000001
000000001

111111110
011110100
011111111
111111111
111101111
111111111
100111100
111111110
111111111

111111100
000000100
000000111
000000001
000000001
000000111
000000100
000000110
000000011

111001111
100011111
110111111
111010111
111111111
101101110
111111101
111111101
111111101

111111110
111101101
110110111
111101101
111011110
111111111
101111011
111111100
011101111

111111100
000000100
000000100
000000100
000000110
000001110
000001000
000001100
000000111

111011101
111111101
011011101
011101111
110111111
101111111
111011111
111111101
110101111

111000000
001111100
000000100
000000111
000000001
000000001
000000001
000000001
000000001

111111111
111011111
101111011
110111100
011111101
101111111
101011011
101111110
111111111

111111111
000001111
000001000
000001100
000000100
000000111
000000011
000000010
000000011

11:31
16:1:2023
110111111
111101111
111111110
111110111
110101111
111110111
101111110
111000111
011110111

110000000
011100000
000111110
000000011
000000001
000000011
000000010
000000011
000000001

11:32
16:1:2023

111111111
111110111
111110111
111111011
111110110
100111111
111001110
011111111
101111011

111111111
000000001
000000001
000000011
000000010
000000010
000000010
000000011
000000001

13:9
16:1:2023

111111011
001101110
111111111
111101111
111110101
101110110
110111111
111111101
111111111

111111000
000001110
000000011
000000111
000000100
000000110
000000011
000000001
000000001

13:15
16:1:2023

111111111
110111011
111111111
101101111
011011101
111111101
011001101
100111101
111111111

111111111
000000001
000000001
000000001
000000001
000000001
000000001
000000001
000000001

13:24
16:1:2023

101011111
111110111
111101010
011111110
011111011
111101111
111111010
111110111
111011111

100000000
111100000
000100000
000111110
000000011
000000011
000000010
000000011
000000001

13:25
16:1:2023

101111111
111111010
111110111
111101111
101111111
111101110
101111111
111100111
111010101

100000000
111110000
000110000
000100000
000111110
000000010
000000011
000000001
000000001

13:26
16:1:2023

111101011
111011111
011111111
111110111
101111101
100011001
111111011
101111110
111111111

111000000
001000000
001111111
000000001
000000001
000000001
000000011
000000010
000000011

